{
	"maps" : [
		{
			"terrain" : [
				[2, 2, 2, 2, 2, 2, 9, 10, 11,  2,  2,  2,  2,  2,  2],
				[2, 2, 2, 2, 2, 2, 9, 10, 11,  2,  2,  2,  2,  2,  2],
				[2, 2, 2, 2, 2, 2, 9, 10, 11,  2,  2,  2,  2,  2,  2],
				[2, 2, 2, 2, 2, 2, 9, 10, 11,  2,  2,  2,  2,  2,  2],
				[2, 2, 2, 2, 2, 2, 9, 10, 11,  2,  2,  2,  2,  2,  2],
				[2, 2, 2, 2, 2, 2, 9, 10, 11,  2,  2,  2,  2,  2,  2],
				[2, 2, 2, 2, 2, 2, 9, 10,  8,  6,  6,  6,  6,  6,  6],
				[2, 2, 2, 2, 2, 2, 9, 10, 10, 10, 10, 10, 10, 10, 10],
				[2, 2, 2, 2, 2, 2, 9, 10, 12, 14, 14, 14, 14, 14, 14],
				[2, 2, 2, 2, 2, 2, 9, 10, 11,  2,  2,  2,  2,  2,  2],
				[2, 2, 2, 2, 2, 2, 9, 10, 11,  2,  2,  2,  2,  2,  2],
				[2, 2, 2, 2, 2, 2, 9, 10, 11,  2,  2,  2,  2,  2,  2],
				[2, 2, 2, 2, 2, 2, 9, 10, 11,  2,  2,  2,  2,  2,  2],
				[2, 2, 2, 2, 2, 2, 9, 10, 11,  2,  2,  2,  2,  2,  2],
				[2, 2, 2, 2, 2, 2, 9, 10, 11,  2,  2,  2,  2,  2,  2]
			],
			"xJoueur" : "6",
			"yJoueur" : "0",
			"direction" : "2"
		},
		{
			"terrain" : [
				[2, 2, 2, 2, 2, 2, 9, 10, 11,  2,  2,  2,  2,  2,  2],
				[2, 2, 2, 2, 2, 2, 9, 10, 11,  2,  2,  2,  2,  2,  2],
				[2, 2, 2, 2, 2, 2, 9, 10, 11,  2,  2,  2,  2,  2,  2],
				[2, 2, 2, 2, 2, 2, 9, 10, 11,  2,  2,  2,  2,  2,  2],
				[2, 2, 2, 2, 2, 2, 9, 10, 11,  2,  2,  2,  2,  2,  2],
				[2, 2, 2, 2, 2, 2, 9, 10, 11,  2,  2,  2,  2,  2,  2],
				[2, 2, 2, 2, 2, 2, 9, 2,  8,  6,  6,  6,  6,  6,  6],
				[2, 2, 2, 2, 2, 2, 9, 2, 10, 10, 10, 10, 10, 10, 10],
				[2, 2, 2, 2, 2, 2, 9, 2, 12, 14, 14, 14, 14, 14, 14],
				[2, 2, 2, 2, 2, 2, 9, 10, 11,  2,  2,  2,  2,  2,  2],
				[2, 2, 2, 2, 2, 2, 9, 10, 11,  2,  2,  2,  2,  2,  2],
				[2, 2, 2, 2, 2, 2, 9, 10, 11,  2,  2,  2,  2,  2,  2],
				[2, 2, 2, 2, 2, 2, 9, 10, 11,  2,  2,  2,  2,  2,  2],
				[2, 2, 2, 2, 2, 2, 9, 10, 11,  2,  2,  2,  2,  2,  2],
				[2, 2, 2, 2, 2, 2, 9, 10, 11,  2,  2,  2,  2,  2,  2]
			],
			"xJoueur" : "10",
			"yJoueur" : "10",
			"direction" : "3"
		},
		{
			"terrain" : [
				[ 5,  6,  6,  6,  6,  6,  4, 10, 11,  2,  2,  2,  1,  2,  2], 
				[ 9, 10, 12, 14, 14, 14,  16, 10, 11,  2,  2,  2,  2,  2,  2], 
				[13, 16, 11,  2,  2,  2,  9, 10, 11,  2,  2,  2,  2,  2,  2], 
				[ 2,  9, 11,  2,  2,  2,  9, 10, 11,  2,  2,  2,  2,  2,  2], 
				[ 2,  9, 11,  2,  2,  2,  9, 10, 11,  2,  2,  2,  2,  2,  2], 
				[ 2,  9, 11,  2,  2,  2,  9, 10, 11,  2,  2,  2,  2,  2,  2], 
				[ 1,  9, 11,  2,  2,  2,  9, 10,  8,  6,  6,  6,  6,  6,  6], 
				[ 2,  9, 11,  2,  2,  2,  9, 10, 10, 10, 10, 10, 10, 10, 10], 
				[ 2, 13, 15,  2,  2,  2,  9, 10, 12, 14, 14, 14, 14, 14, 14], 
				[ 2,  2,  2,  2,  2,  2,  9, 10, 11,  2,  2,  2,  2,  2,  2], 
				[ 2,  2,  2,  2,  2,  2,  9, 10, 11,  2,  2,  2,  2,  2,  2], 
				[ 2,  2,  2,  2,  2,  2,  9, 10, 11,  2,  2,  2,  2,  2,  2], 
				[ 2,  2,  2,  2,  2,  2,  9, 10, 11,  2,  2,  2,  2,  2,  2], 
				[ 2,  2,  2,  2,  2,  2,  9, 10, 11,  2,  2,  2,  2,  2,  2], 
				[ 2,  2,  2,  2,  2,  2,  9, 10, 11,  2,  2,  2,  2,  2,  2]
			],
			"xJoueur" : "1",
			"yJoueur" : "1",
			"direction" : "0"
		}
	]
	
}
